11111111111111111111111111111111111111111111111111
11111111111111111111111111111111111111111111111111
11                                              11
11                                              11
11                                              11
11                                              11
11                                              11
11 D                                            11
11                                              11
11                                              11
111111111111 1111111111111111                   11
111111111111 1111111111111111                   11
111111111111 1111111111111111                   11
111111111111 1111111111111111                   11
11                                              11
11                                              11
11                                              11
11                                              11
11                                              11
11                                              11
11                                              11
11                                              11
11                                              11
11                                              11
11                           111111111111111111111
11                           111111111111111111111
11                           111111111111111111111
11                           111111111111111111111
11                                              11
11                                              11
11                                              11
11                                              11
11                                              11
11                                              11
11                                              11
11                                              11
11                                              11
11                                              11
11                                              11
11                                              11
11                                              11
11                                            E 11
11                                              11
11                                              11
11111111111111111111111111111111111111111111111111
11111111111111111111111111111111111111111111111111