11111111111111111111111111111111111111111111111111
11111111111111111111111111111111111111111111111111
11                                              11
11                                              11
11                                              11
11                                              11
11                                              11
11 D                                         E  11
11                                              11
11                                              11
1111111111       111111111111111111111111111111111
1111111111       111111111111111111111111111111111
1111111111       111111111111111111111111111111111
1111111111       111111111111111111111111111111111
11                                              11
11                                              11
11                                              11
11                                              11
11                                              11
11                                              11
11                                              11
11                                              11
11                                              11
11                                              11
11                                              11
11                                              11
11                                              11
11                                              11
11                                              11
11                                              11
11                                              11
11                                              11
11                                              11
11                                              11
11                                              11
11                                              11
11                                              11
11                                              11
11                                              11
11                                              11
11                                              11
11                                              11
11                                              11
11                                              11
11111111111111111111111111111111111111111111111111
11111111111111111111111111111111111111111111111111